C 221,100 ,30
NO      ./textures/greystone.xpm
SO ./textures/bookshelf.xpm
EA ./textures/bluestone.xpm
WE ./textures/mossy.xpm

F  000, 000, 00


111111111111111111111111111111111111111           11111
110000000000000000000000000000000000011           111111
1
100000001010000000000000000000001000001				1N01
100000010010000000000000000000001000001			0
100000100010000000000000000000001000001
100001000010000000000000000000001000001
100011111111111000000000011111111000001
100000000010000000000000010000000000001
100000000010000000000000010000000000001
100000000010000000000000010000000000001
100000000010000000000000010000000000001
100000000010000000000000011111111000001
100000000000000000000000000000000000001
110000000000000000000000000000000000111
111111111111111111111111111111111111111









