C 255,20 ,30
NO      ./textures/greystone.xpm
SO ./textures/bookshelf.xpm
EA ./textures/bluestone.xpm
WE ./textures/mossy.xpm

F  000, 000, 00


1111111111111111111111111111111111111111111111111111111111111111111111111111111
1000000000000000000000000000000000000000000000000000000000000000000000000000001
1011111111111000000000000000000000000000000100000000000000001001111000000000001
1000000000000000000000000000000000000000000000000000000000000000000000000000001
1000000000000000000000000000000000000000000000000000000000000000000000000000001
1000000000000000000000000000000000000000000000000000000000000000000000000000001111
1000000000000000000000000000000000000000000000000000000000000000000000000000000001
100000000000000000000000000000000S000000000000000000000000000000000000000000001111
1000000000000000000000000000000000000000000000000000000000000000000000000000001
11111111111000000000000100000000000000000000000000000000000000001000000000000001
1000000001000000000000000000000000000000000000000000000000000000000000000000001
1000000001000000000000000000000000000000000000000000000000000000000000000000001
1000000000000000000000000000000000000000000000000000000000000000000000000000001
1000000001000000000000000000000000000000000000000000000000000000000000000000001
1000000001000000000000000000000000000000000000000000000000000000000000000000001
1000000001110000000000000000000000000000000000000000000000000000000000000000001
1000000000000000000000000000000000000000000000000000000000000000000000000000001
1000000000000000000000000000000000000000000000000000000000000000000000000000001
1000000000000000000000000000000000000000000000000000000001000000000000000000001
1000000000000000000000000000000000000000000000000000000000000000000000000000001
1000000000000000000000000000000000010000000000000000000000000000000000000000001
1000000000000000000000000000000001110000000000000000000000000000000000000000001
1000000000000000000000000000000000000000000000000000000000000000000000000000001
1000000000000000000000000000000000000000000000000000000000000000000000000000001
1000000000000000000000000000000000000000000000000000000000000000000000000000001
1000000000000000000000000000000000000000000000000000000000000000000000000000001
1111111100000000000000000000000000000000000000000000000000000000000000000000001
1000001100000000000000000000000000000000000000000000000000000000000000000000001
1000000000000000000000000000000000000000000000000000000000000000000000000000001
1000000100000000000000000000000000000000000000000000000000000000000000000000001
1111111111111111111111111111111111111111111111111111111111111111111111111111111
