C 255,20 ,30
NO ./textures/bookshelf.xpm
SO ./textures/red.xpm
EA ./textures/mossy.xpm
WE ./textures/bluestone.xpm

F  000, 000, 00



111111111111111111111111111111
111111111000000000000000011111
100000000000000001110001000011
110000100000000000000000001111
100001111111000000000000111111
1111111000000000N0000000000001
111100000000001100000000000011
1                            1
110000000000011110000000000011
1000000000001110E0000000000001
110000000000111000000000001111
11000000000111100000000000011
111111111111111111111111111111
