C 255,20 ,30
NO ./textures/bookshelf.xpm
SO ./textures/red.xpm
EA ./textures/mossy.xpm
WE ./textures/bluestone.xpm

F  000, 000, 00

1111111111111N1111111111111111
111111111000000000000000011111
100000000000000000111000100001
110000100000000000000000001111
100001111111000000000000111111
111111100000000000000000000001
111100000000001100000000000011
1                            1
110000000000011110000000000011
100000000000111000000000000011
110000000000111000000000001111
110000000001111000000000000111
111111111111111111111111111111111
