C 255,20 ,30
NO ./textures/bookshelf.xpm
WE ./textures/bluestone.xpm
SO ./textures/red.xpm
EA ./textures/mossy.xpm

F  000, 000, 00

111111111111111111
100000000000000001
100600000000000001
10000000N000000001
100000000000000001
111111111111111111

