C 22@@1,100 ,30
NO      ./textures/greystone.xpm
SO ./textures/bookshelf.xpm
EA ./textures/bluestone.xpm
WE ./textures/mossy.xpm

F  10@=*9, 80, 00


111111111111111111111111111111111111111
110000000000000000000000000000000000011
100000000000000000000000000000000000011
100000000110000000000000011111111000001
100000001010000000000000000000001000001
100000010010000000000000000000001000001
100000100010000000000000000000001000001
100001000010000000000000000000001000001
1000111111111110000N0000011111111000001
100000000010000000000000010000000000001
100000000010000000000000010000000000001
100000000010000000000000010000000000001
100000000010000000000000010000000000001
100000000010000000000000011111111000001
100000000000000000000000000000000000001
110000000000000000000000000000000000001
111111111111111111111111111111111111111